SO ./PICTO_PXL.xpm
NO ./PICTO_PXL.xpm
EA ./PICTO_PXL.xpm
WE ./PICTO_PXL.xpm

F 000,100,0
C 0,0,255

111111
100001
100001
100001
100001
10S001
100001
111111