SO south
NO    north
EA   east
WE west

F 2a0,100,0
C 225,30,0

11111111
100N000001111
11000111111
111111111