SO lalal
NO lalal
EA lalal
WE lalal

1111111
1000001
1000001
1111111