SO ./PICTO_PXL.xpm
NO ./PICTO_PXL.xpm
EA ./PICTO_PXL.xpm
WE ./PICTO_PXL.xpm

F 000,100,0
C 005,30,0



111111
100001
100001
10N001
100001
111111