SO south
NO    north
EA   east
WE west

F 200,100,0
C 225,30,0

11111111
100N0001
11000111
11111111