SO ./pics/eagle.png
NO ./PICTO_PXL.xpm
EA ./PICTO_PXL.xpm
WE ./PICTO_PXL.xpm

F 200,100,0
C 225,30,0

11111111
100N0001
11000111
11111111