SO ./PICTO_PXL.xpm
NO ./PICTO_PXL.xpm
EA ./PICTO_PXL.xpm
WE ./PICTO_PXL.xpm

F 000,100,0
C 0,0,255


111111111111
100011110001
100000000001
100000000001
10000E000001
100000000001
111111111111