F 0,0,0
C 120,0,120

SO ./textures/eagle.xpm
NO ./textures/eagle.xpm
EA ./textures/eagle.xpm
WE ./textures/eagle.xpm


1111111111111111111111
1000000000000000000001
1111111100000000000001
1000000000000000000001
1000000001000000000001
1000000001000000000001
100000000100000W000001
1000000001000000000001
1000000011000000000001
1000000100000000000001
1000000110000000000001
1000000000000000000001
1111111111111111111111
