SO ./PICTO_PXL.xpm
NO ./PICTO_PXL.xpm
EA ./PICTO_PXL.xpm
WE ./PICTO_PXL.xpm

C 255,200,
F 10,10,10
r
11111111111111111
10000000000000001
10000000000000001
10000000000000001
10000000000000001
10000000000000001
10000000N00000001
10000000000000001
10000000000000001
10000000000000001
10000000000000001
10000000000000001
11111111111111111