F 0,0,0
C 120,0,120

SO ./textures/eagle.xpm
NO ./textures/eagle.xpm
EA ./textures/eagle.xpm
WE ./textures/eagle.xpm


1111111111111111111111
1000000000000000000001
1000010000000000000001
1000010000000000000001
1000010000000110000001
1000010000000000000001
1000001100000000000001
1000000000000000000001
1000000000000000000001
1000000000000000000001
10000000000000N0000001
1000000000000000000001
1111111111111111111111
