F 0,10,0
C 120,0,120

SO ./textures/eagle.xpm
NO ./textures/red.xpm
EA ./textures/greystone.xpm
WE ./textures/purplestone.xpm


111
1N1
1111