SO ./textures/eagle.xpm
NO ./textures/eagle.xpm
EA ./textures/eagle.xpm
WE ./textures/eagle.xpm

F 000,100,0
C 0,0,155


           1111111111111111111111111
           1000000000110000000000001
           1011000001110000001000001
           1001000000000000000000001
111111111111000001110000000000001111
100000000011000001110111110011111
11110111111111011100000010001           
11110111111111011101010010001
11000000110101011100000010001
10001000000000001100000000001
10000000000000001101010010001
11000001110101011111011110N0111
11111111 111111 111111  11111