SO ./textures/eagle.xpm
NO ./textures/eagle.xpm
EA ./textures/eagle.xpm
WE ./textures/eagle.xpm

F 000,100,0
C 0,0,155


1111111111111111111
1000000000000000001
1000000000000000001
1000000100000000001
1000000000000000001
1000000000000000001
10000000N0000100001
1000000000000000001
1111111111111111111